2222333333322222233333322222223332222222
2000000000000400000000000000000000000003
2000000000000400000000000000000000000003
3000000000000000000000000000004000000003
3000000000000000000000000000045000000003
2444444000000000000000000000000000000003
2000000000000000000000000000000000000003
2000000000000000000000000004444000000003
2000000000000000000000000000000000000002
2000000000000000000000000000000000000002
2550000000004554000000045540000000000002
2555000000004554000000045540000000000002
3005550000000000000000000000000000000002
3000555440000000000000000000000000000002
3000000000000000000000000000000000000002
2000000000000000000000000000000000000002
3000444400000000333333000000004444440002
2000000000000000000000000000000000000002
2000000000000000000000000000000000000003
2400004444000000000000333300000044440003
2000000000000000000000000000000000000002
2000000000000000000000000000000000000002
2004444440000000000000000000000000000002
2000000004400000000000000000000000444443
3000000000044444400000000000000044000003
3000000000000000000000000000000440000003
3000000000000000000044000004444400000002
2000000000000000000000000000000000000003
2000440000000000000000000000000000000003
2000440000000000000000000000000000000002
2000004400000444444000000004444440000002
2000000440000000000000000000000000000002
2000000044000000000000000000000000000002
2000000000000000000000000000000000000002
2000000000000000000000000000004444444442
2000000000000000000000000000000000000003
2000000000000000000000000000000000000003
2000000000000000000000000040000000000003
2000000000000000000000000040000000000002
2333322222233333333222222233333222222222