4444444444444444444444444444444444444444
4000000000000400000000000000000000000004
4000000000000400000000000000000000000004
4000000000000000000000000000004000000004
4000000000000000000000000000045000000004
4444444444444400000000000000004000000004
4000000000000000000000000000004000000004
4000000000000000000000000004444000000004
4000000000000000000000000000000000000004
4000000000000000000000000000000000000004
4550000000004554000000045540000000000004
4555000000004554000000045540000000000004
4005550000000000000000000000000000000004
4000555440000000000000000000000000000004
4000000000000000000000000000000000000004
4000000000000000000000000000000000000004
4000444444444444400000044444444444440004
4000000000000000000000000000000000000004
4000000000000000000000000000000000000004
4000044440000004444444444000000444400004
4000000000000000000000000000000000000004
4000000000000000000000000000000000000004
4044444440000000000000000000000000000004
4000000004400000000000000000000000444444
4000000000044444400000000000000044000004
4000000000000000000000000000000440000004
4000000000000000000044555666554400000004
4000000000000000000000000000000000000004
4000440000000000000000000000000000000004
4000440000000000000000000000000000000004
4000004400000444444000000004444440000004
4000000440000000000000000000000000000004
4000000044000000000000000000000000000004
4000000440000000000000000000000000000004
4000044000000000000000000044444444444444
4000440000000000000000000000000000000004
4000000000000000000000000000000000000004
4000000000000000000000000040000000000004
4000000000000000000000000040000000000004
4444444444444444444444444444444444444444