00000000000000000000
05050050050050050050
00000000000000000000
00500500500500500500
00000000000000000000
05050050050050050050
00000000000000000000
00500500000000500500
00000000111100000000
00600001133110000600
00600001133110000600
00000000111100000000
00500500000000500500
00000000000000000000
05050050050050050050
00000000000000000000
00500500500500500500
00000000000000000000
05050050050050050050
00000000000000000000