1111111111111111111111111111111111111111
1000000000000000000000000000000000000001
1000011111100000000000000000001000000001
1000000000100000000000001000001000000001
1000000000100000000000001000001000000001
1000000000100000000000011000001000000001
1000000000100000110000000000001000000001
1000000000100000110000000000001000000001
1000001111100000000000000000001000000001
1000011000000000001211111100111000000001
1000010000000000100000000000000000000001
1000002000000000000000000000000000000001
1000000000000000000000012100000000000001
1000000000000000000000013200000000000011
1111111110000000000000000000000000001101
1000000001000000001100000000001111110001
1000000000111111110000000000000000000001
1000000000000000000000000000000000000001
1000000000000000000000000000001000000001
1000000000000000000000000000000000000001
1000000000000000000000000000000000000001
1000000000000000000000000000000000000001
1000011111100000000000000000001000000001
1000000000100000000000001000001000000001
1000000000100000000000001000001000000001
1000000000100000000000011000001000000001
1000000000100000110000000000001000000001
1000000000100000110000000000001000000001
1000001111100000000000000000001000000001
1000011000000000001211111100111000000001
1000010000000000100000000000000000000001
1000002000000000000000000000000000000001
1000000000000000000000012100000000000001
1000000000000000000000013200000000000011
1111111110000000000000000000000000001101
1000000001000000001100000000001111110001
1000000000111111110000000000000000000001
1000000000000000000000000000000000000001
1000000000000000000000000000001000000001
1111111111111111111111111111111111111111